*S*******************
*     *   *         *
* ***** * ******* ***
* * *   * *   * *   *
* * * * * *** * *** *
*     * *           *
*********** *********
*         *   *     *
*** * ******* *** ***
* * * *     *       *
* * ***** *** *** * *
*           * *   * *
* ********* * * *** *
* *     * * * * *   *
* *** *** ********* *
*     *       *   * *
***** * * ***** * * *
* * *   *       *   *
* * * ************* *
*             *     E
*********************