*******************************************************************************************************************************************************
S     *     *  *        *  *     *              *           *     *     *        *     *  *  *                       *     *                 *        *
*  *  *  ****  *******  *  ****  *************  ****  ****  *  *  ****  ****  ****  ****  *  ****  ****  *******  *  ****  *  *  *************  *******
*  *     *  *  *           *  *        *  *  *           *  *  *  *        *     *        *     *     *  *        *  *     *  *     *  *  *           *
*  *******  *  *  *  *******  *******  *  *  *  ****  *  *  *  *******  ****  *******  *  *  *  *  *  *******  *******  **********  *  *  *  *  *******
*        *  *     *  *  *  *  *     *  *     *     *  *  *     *           *        *  *     *  *  *        *  *        *  *     *     *     *     *  *
*  *******  *******  *  *  *  *  ****  *  *  *************  *  **********  *  *  **********  *******  ****  *******  *  *  *  *  ****  ****  *  *  *  *
*        *  *                 *     *     *              *  *     *           *  *     *     *     *  *     *     *  *        *              *  *  *  *
*  *  *  *  *  ****  ****  *  *  ****  *  *  ****  *  *******  ****  *  ****  ****  ****  *  *  *  *  ****  *  *******  *  *************  ****  *  *  *
*  *  *           *  *  *  *           *  *     *  *        *        *     *        *     *     *        *     *  *     *           *        *  *     *
****  ****  ****  ****  *  *  *  *  ****  *  *******  *  *  *  ****  ****  ****  *************  ****  *  ****  *  ****  *  *  ****  *******  ****  *  *
*  *     *     *        *  *  *  *  *     *        *  *  *        *     *     *     *  *     *     *  *  *     *     *  *  *  *           *     *  *  *
*  *  *******  **********  *  *******  **********  **********  *******  **********  *  ****  *  *  *******  *  ****  ****  *******  *  *************  *
*        *              *  *  *  *  *  *     *  *  *  *  *  *  *           *  *     *           *  *  *     *     *  *        *  *  *     *     *     *
*******  ****  *************  *  *  ****  ****  ****  *  *  ****  *******  *  *******  ****  *******  *  ****  *  *  *******  *  *******  ****  *  *  *
*     *  *              *  *        *  *  *     *     *        *     *        *  *  *  *  *     *        *     *        *     *     *           *  *  *
*  *  **********  *  ****  ****  *  *  *  *  *  ****  *  *************  ****  *  *  *  *  *  *******  ****  ****  ****  *  ****  **********  ****  *  *
*  *  *        *  *        *  *  *  *        *  *        *                 *  *     *     *  *  *  *     *  *     *     *           *     *  *     *  *
*  ****  *  **********  ****  *  *************  *******  *  ****************  *  *******  ****  *  *  *  **********  *  *  *  **********  ****  *  ****
*     *  *     *  *     *  *        *     *     *     *  *  *     *  *           *        *     *     *  *        *  *  *  *  *     *  *        *     *
*  ****  *******  ****  *  ****  *******  *  *******  *  *******  *  *******  ****  *******  *  *  **********  *******  ****  *  *  *  *  ****  *  *  *
*     *  *           *     *  *     *     *     *           *  *     *  *  *                 *  *        *  *        *        *  *  *  *     *  *  *  *
****  *  *  ****  *  *******  ****  *  *  *  *  ****  *  ****  *  ****  *  *  *  *************************  *  *  ****  *  *  *  ****  ****  *  *  *  *
*  *           *  *  *     *           *     *     *  *        *     *     *  *     *              *           *     *  *  *  *     *  *     *  *  *  *
*  **********  *******  *******************  *  ****  **********  ****  *  *  *******  ****  ****  ****  **********  *  *  *******  *  *  ****  ****  *
*                 *  *           *  *  *     *        *     *        *  *              *     *  *     *  *  *  *  *     *     *     *  *  *     *  *  *
*  *************  *  *******  ****  *  *******  *******  ****  *  **********  *  *******  ****  *******  *  *  *  ****  ****  *  *  *  ****  *  *  *  *
*     *     *                 *  *  *  *  *                 *  *           *  *     *  *        *     *  *  *  *     *     *  *  *  *        *  *  *  *
*  *  ****  *  *******  *******  *  *  *  *******  *  **********  *******  *  ****  *  *  *  *******  *  *  *  *  *  *  *******  *  ****  *  *  *  *  *
*  *        *  *           *  *     *        *  *  *  *           *  *  *  *     *  *     *  *     *        *     *        *  *  *  *     *  *  *     *
****  *************  ****  *  ****  ****  ****  ****  *  *  *  ****  *  *************  ****  ****  *  *  *  **********  *  *  ****  *  **********  ****
*        *     *     *                 *           *     *  *        *     *  *  *     *     *  *     *  *  *           *           *  *     *  *     *
*  ****  ****  **********  *  **********  **********  *******  *  *  ****  *  *  ****  *******  *  ****************************  ****  *  ****  ****  *
*  *                 *     *  *  *           *     *  *  *     *  *  *  *           *     *           *     *  *        *     *  *  *              *  *
*  ****  ****  *  *  *  ****  *  *  *******  *  *******  **********  *  ****  **********  *******  *  *  *  *  *******  ****  *  *  ****  *  ****  ****
*  *        *  *  *  *     *           *     *        *           *  *  *        *              *  *  *  *                 *     *     *  *     *  *  *
****  *  ****  *******  *  ****  *  **********  **********  *  *******  *  *  *  *  ****  ****  *  **********  *******  **********  ****  *  *******  *
*     *  *  *  *  *  *  *  *  *  *  *        *        *  *  *        *     *  *  *     *     *  *                 *  *  *        *     *  *        *  *
*  *  ****  ****  *  *  ****  ****  *  *  **********  *  *******  ****  ****  ****  **********  *******  *  *  ****  *  *  *******  ****************  *
*  *           *        *  *           *  *           *        *     *  *        *  *           *        *  *        *     *  *                 *  *  *
****  *  *******  *  *  *  *  *  *  ****************  *  *  *******  ****  *  ****  *  ****  ****  ****  *  *  *  *******  *  *  *  *  *  *  *  *  *  *
*     *  *        *  *  *     *  *  *     *              *  *     *  *  *  *        *  *  *     *  *     *  *  *  *  *     *     *  *  *  *  *  *     *
*  ****************  *  *******  ****  ****  *  ****  ****  *  ****  *  ****  **********  *  ****  **********  ****  ****  *  *************  ****  *  *
*  *        *        *  *        *  *  *     *  *     *           *  *  *           *  *        *  *  *        *  *  *        *  *  *           *  *  *
****  *  *  ****  *  *  *  *  ****  *  *******  ****  *  **********  *  *  **********  ****  *******  *  *  *  *  *  *  *  *  *  *  *  *  ****  *  *  *
*     *  *  *     *  *  *  *           *        *  *  *     *  *  *        *        *     *  *  *  *     *  *  *     *  *  *  *     *  *  *     *  *  *
*******  **********  *******  ****  *  **********  *  ****  *  *  *******  *  **********  ****  *  ****  *******  *  *  ****  *  *  *  *******  ****  *
*        *  *           *     *  *  *                 *  *     *                       *                 *        *     *     *  *        *  *  *     *
*  ****  *  *******  **********  *  ****  **********  *  *  **********  **********  ****  *******  ****  *******  *  *******  *******  ****  *  *  ****
*  *                 *     *     *  *  *     *  *     *           *        *           *     *     *  *  *        *        *     *     *              *
*  ****  ****************  *  *******  *  ****  *************  *******  *  ****  *  *  *******  ****  ****  ****  ****************  *************  ****
*  *  *  *        *     *              *  *              *  *     *  *  *  *     *  *  *     *  *  *  *     *     *  *  *        *  *     *  *  *     *
****  **********  *  ****  *  *  ****  ****  ****  *******  ****  *  *  *******  ****  *  *  ****  *  *  *  *******  *  *  **********  ****  *  ****  *
*     *           *  *  *  *  *  *           *           *              *  *     *     *  *     *  *     *        *                 *  *  *  *     *  *
****  *  *  *  ****  *  *******  *************************  *******  *  *  *  ****  *  *******  *  ****  ****  *******  **********  *  *  *  *  *  *  *
*     *  *  *              *     *        *        *           *     *  *     *  *  *     *        *     *  *     *     *        *     *        *     *
*  *  *******  ****  **********  *  *  *  *  **********  *******  ****  ****  *  *  *  ****  *  *  ****  *  *  ****  *******  *******  *******  *  *  *
*  *           *  *  *  *           *  *        *           *     *     *     *     *  *  *  *  *     *  *           *        *        *        *  *  *
*******  ****  *  *  *  *  *******  ****  **********  *  *  **********  ****************  **********  *  *******  **********  *  *******  *  *  ****  *
*  *        *     *        *     *     *  *     *     *  *  *  *              *        *              *     *                 *  *  *  *  *  *  *     *
*  ****  *  *  *  *  ****  ****  *  ****  *  *  ****  *******  ****  ****************  *  **********  *******  *  *  *  *  ****  *  *  ****  *  *  ****
*        *  *  *  *  *  *  *           *  *  *        *           *  *     *  *           *     *     *  *  *  *  *  *  *  *        *  *     *  *     *
*  *  *******  *  ****  *******  ****  *******  *  ****  *  *************  *  *  *  *  *  ****  ****  *  *  **********  *  *******  *  **********  *  *
*  *     *     *  *           *     *  *        *  *     *  *           *        *  *  *        *     *  *           *  *  *  *        *     *  *  *  *
*  **********  *  *  *******  *  ****  *******  ****  *******  ****  ****  ****  ****  **********  ****  ****  *  *  *******  ****  *  *  ****  ****  *
*     *  *     *  *        *  *     *     *     *  *  *        *     *        *     *     *           *  *     *  *                 *     *     *     *
*******  *  *  *******  *  ****  *******  *  ****  *  *******  *  ****  ****  *  ****  **********  *  *  *  **********  ****  *  *  *******  ****  *  *
*           *     *     *        *     *  *  *           *  *  *     *  *     *  *  *           *  *     *  *        *  *  *  *  *        *     *  *  *
*  ****  ****  *  *  *  *************  ****  *  **********  *  *  ****  *  *******  *******  *******  *  *******  *******  *  *************  *  ****  *
*  *  *  *     *  *  *           *              *     *        *  *     *  *              *  *        *        *     *              *        *     *  *
****  *  *  *  *  *  ****  ****  ****  *  *******  *******  *  ****  ****************  *******  *******  **********  **********************  *******  *
*        *  *  *  *     *  *           *        *        *  *              *     *  *  *           *     *                    *  *           *  *     *
**********  *******  ****  ****  *******  ****  ****  ****  ****  *******  ****  *  *  *******  *******************  *******  *  ****  *  ****  *  *  *
*  *     *        *     *  *  *  *           *           *     *     *           *     *     *     *  *  *           *        *  *     *     *     *  *
*  ****  *  ****************  ****  ****  ****  *  *  *  *  *  *  *******  *  *  ****  *  *  *  *  *  *  *  ****************  *  *  ****  *  *******  *
*     *  *  *        *     *  *        *  *  *  *  *  *     *  *  *  *  *  *  *        *  *  *  *  *  *  *     *     *           *  *  *  *     *     *
****  *  *******  *  *  ****  *  ****  ****  **********  **********  *  ****  ****  *  *  *  *******  *  *  ****  ****  *******  *  *  ****  ****  ****
*        *  *     *  *     *        *     *     *           *  *           *  *  *  *     *     *        *        *     *        *     *        *     *
*  *******  ****  *******  ****  *******  *  **********  ****  *  *  **********  **********  ****  **********  *******  *  *  ****************  ****  *
*     *  *           *     *        *        *        *  *  *  *  *           *  *     *     *  *           *     *     *  *        *                 *
****  *  *  *******  *  ****  ****  ****  *  *  **********  *  *******  *  ****  ****  ****  *  ****  ****  *******  ****  ****  **********  *  ****  *
*  *        *     *  *     *     *     *  *  *  *              *        *              *        *     *     *  *  *  *        *        *     *  *     *
*  *******  ****  *  ****  **********  *  ****  *  ****  *  *  ****  *************************  *  *  *  ****  *  ****  *  ****  *  *******************
*     *     *        *  *        *     *  *  *        *  *  *  *           *        *     *  *     *  *  *  *           *  *  *  *        *        *  *
*  ****  *  *  *  ****  *  ****************  *  **********  *******  ****  *  ****  *  ****  *  ****  ****  *  ****  ****  *  ****  *******  *  *  *  *
*  *     *  *  *     *                       *     *     *              *     *  *                 *        *  *  *     *  *  *     *        *  *     *
*  *  **********  *  ****  *******  ****  *******  ****  ****  *******  *  ****  **********  ****  *  *  *******  *  *******  *  *  *  **********  *  *
*     *  *  *  *  *  *        *        *        *  *  *        *     *  *           *  *     *     *  *     *  *        *  *     *        *     *  *  *
*  ****  *  *  *  ****  *  *******  *******  *******  *  ****  *  *  *  *  ****  ****  ****  *************  *  *  *******  *************  ****  ****  *
*        *  *  *        *        *     *  *     *     *  *     *  *  *  *     *     *        *  *  *                 *                 *  *        *  *
*  *  ****  *  *  ****  **********  *  *  *  *******  ****  *  ****  ****  ****  *******  *  *  *  *  **********  **********  *  ****  *  ****  *  ****
*  *     *        *  *  *     *  *  *     *  *        *     *     *        *        *     *  *        *  *     *  *  *        *  *     *        *  *  *
****  *  *  *******  *  ****  *  *  *  ****  *  **********  *  *************  *  *  *  ****  *  ****  *  *  *******  *******  *******  ****  *  ****  *
*     *  *  *              *        *  *  *        *     *  *  *           *  *  *  *     *  *  *                                   *     *  *        *
*  *******  **********  *******  *  ****  *******  *  ****  *******  *  *  *************  *************  *  *  *  *  *  *  ****  *  *******  ****  *  *
*  *  *     *     *     *     *  *              *  *     *     *  *  *  *  *     *              *        *  *  *  *  *  *  *     *  *  *  *  *  *  *  *
****  ****  *  *  **********  ****  ****  ****  *  *  *******  *  ****  ****  *  **********  ****  *******  ****  ****  *************  *  ****  ****  *
*     *        *  *           *  *     *  *  *  *  *  *           *  *        *           *  *  *  *     *  *        *                 *        *     *
*  *  *******  ****  **********  *  *******  *  ****  ****  *******  *  ****  *******  ****  *  *  ****  *******  *  *******  *******  *  ****  ****  *
*  *           *                    *                          *           *     *           *     *              *  *           *           *     *  E
*******************************************************************************************************************************************************  
